q1			
请问有什么可以帮到您的吗	請問有咩可以幫到你		
请问有什么可以帮到你的吗	請問有咩可以幫到你		
请问要如何帮到您	請問有咩可以幫到你		
请问要怎么帮到您	請問點先可以幫到你		請問要點先可以幫到你
您需要什么	你需要啲咩野		請問你需要咩野
请问你有什么需要吗	請問你有咩野需要嗎		你需要幫助嗎
您有什么需求吗	你有咩需要嗎		
您要做什么呢	你要做咩野呢		
要怎么帮助你呢	要點樣幫你呢		
需要什么服务吗	需要咩野服務嗎		
我要如何帮助您呢	我要點樣幫你呢		
请问您有什么需要呢	請問你有咩野需要呢		
我应该如何服务您呢	我應該點樣服務你呢		
您需要什么帮助吗	你需要咩幫助嗎		
请问有什么可以帮助你的	請問有咩可以幫到你		
q2			
您要充值多少钱	你要充值幾多錢		
多少钱	幾多錢		
您要充值多少	你要充值幾多		
充值多少	充值幾多		
q2+			
您要充值多少钱	你要充值幾多錢		
多少钱	幾多錢		
您要充值多少	你要充值幾多		
充值多少	充值幾多		
credit			
不行	唔得		
不可以	唔可以		
只能现金	只可以現金		
不好意思，我们只接受现金	唔好意思，我地只係接受現金		
不能用EPS	唔可以用EPS		
不能用信用卡	唔可以用信用卡		
不好意思，不能用信用卡	唔好意思，唔可以用信用卡		
对不起，只能用现金	對唔住，只可以用現金		
不好意思，不可以	唔好意思，唔可以		
只能用现金	只可以用現金		
不好意思，只能用现金	唔好意思，只可以用現金		
paying			
钱不够	唔夠錢		收你50，仲差50
您给的钱不够	你比嘅錢唔夠		
不够，还需要200元	唔夠，仲需要200蚊		
还差100元	仲差100蚊		
还需要50元	仲需要50蚊		
收您50元，还需要50元	收你50蚊，仲需要50蚊		
exit			
充值完毕	充值完		
欢迎下次再来	歡迎下次再黎		
充值好了	充值完		
这是您的账单	呢張係你嘅單		
谢谢惠顾	多謝幫襯		
充值完毕，这是您的账单，欢迎下次再来	充值完，呢張係你既單，歡迎下次再黎		
	充值完，歡迎下次再黎		
